###############
#            O#
#      P   ####
#             #
#             #
#########     #
#  O##        #
#   ##        #
#             #
#             #
#          XX #
#          #  #
###############